mmmmmmmmmmmmmmddmmmmmmmmmmmmmm
m0000000000000000000000000000m
m0000000000000000000000000000m
m0000000000000000000000000000m
m0000000000000000000000000000m
m0000000000000000000000000000m
m0000000000000000000000000000m
m0000oooooooooooooooooooo0000m
m0000o010000000000000020o0000m
m0000o0c00000000000000k0o0000m
m0000o000000000000000000o0000m
m0000ooooooooo00ooooooooo0000m
m0000000000000000000000000000m
m0000000000000000000000000000m
m0000000000000000000000000000m
m0000000000000000000000000000m
m0000000000000000000000000000m
m0000000000000000000000000000m
m0000000000000000000000000000m
mmmmmmmmmmmmmmmmmmmmmmmmmmmmmm